SO ./xpm/pathSO.xpm
NO ./xpm/pathNO.xpm
WE ./xpm/pathWE.xpm
EA ./xpm/pathEA.xpm
F 123,31,3
C 25,21,2


11111111111111
11111100100011
1N111111111111
100000001
11111111111111111
11111111111111111111
11111111111111111
11111111111111111
11111111111111111
11111111111111111
11111111111111111
11111111111111111
11111111111111111
11111111111111111
11111111111111111
11111111111111111
11111111111111111
11111111111111111
11111111111111111
11111111111111111
11111111111111111
11111111111111111
11111111111111111
11111111111111111
11111111111111111
11111111111111111
11111111111111111
11111111111111111
11111111111111111

11111111111111111
11111111111111111
11111111111111111
11111111111111111
11111111111111111
11111111111111111
11111111111111111
11111111111111111
11111111111111111
11111111111111111
11111111111111111
11111111111111111


