SO ./xpm/pathSO.xpm
NO ./xpm/pathNO.xpm
WE ./xpm/pathWE.xpm
EA ./xpm/pathEA.xpm
F 123,31,3
C 25,21,2

111111111111111
1000000N0000001
100000000000001
100000000000001
100000000000001
111111111111101