SO ./xpm/pathSO.xpm
NO ./xpm/pathNO.xpm
WE ./xpm/pathWE.xpm
EA ./xpm/pathEA.xpm
F 123,31,3
C 25,21,2

111111111111111
100000000000001
100000000001111
10000000001N001
1000000000111 1
111111111111111