   	 F			 220,100,0

				C 			225,30,0







NO ./path_to_the_north_texture.xpm

WE ./path_to_the_west_texture.xpm


SO ./path_to_the_south_texture.xpm


EA ./path_to_the_east_texture.xpm




    111111     
    100101      
    101N11      
    100101      
    111111     


